############################
#P.....#.............#....S#
#.###..#.#####.#######.###.#
#...#..#.....#.....M.#...#.#
#.#.#..#####.#####.#.###.#.#
#.#.#.......#....#.#.....#.#
#.#.######.#.###.#.#######.#
#.#......#.#.#...#.....#...#
#.######.#.#.#.#######.#.###
#....M...#...#.....#...#...#
###.#################.###..#
#.....#.......M.....#...E..#
############################